Mm, Mm, Mm, Mm, Mm, Mm, Mm, Mm, Mm, Mm, Mm, Mm, Mm, Mm, Mm, Hhd, Hhd, Hhd, Mm, Mm, Mm, Mm, Mm, Mm, Mm, Mm, Mm, Mm, Mm, Mm, Mm, Mm
Mm, Mm, Mm, Mm, Mm, Mm, Mm, Mm, Mm, Mm, Mm, Mm, Mm, Mm, Mm^Xm, Hhd, Hhd, Mm, Mm, Mm, Mm, Mm, Mm, Mm, Mm, Mm, Mm, Mm, Mm, Mm, Mm, Mm
Mm, Mm, Mm, Mm, Mm, Mm, Mm, Mm, Mm, Mm, Mm, Mm, Mm, Mm, Mm^Xm, Gd, Gd, Mm^Xm, Mm^Xm, Mm, Mm, Mm, Mm, Mm, Mm, Mm, Mm, Mm, Mm, Mm, Hh, Hh
Mm, Mm, Mm, Mm, Mm, Mm, Mm, Mm, Mm, Mm, Mm, Mm, Mm, Mm^Xm, Hh, Gs, Hh, Hh, Mm, Mm, Mm, Mm, Mm, Mm, Mm, Mm, Hh, Mm, Hh^Esa, Hh, Hh, Hh
Mm, Mm, Mm, Mm, Mm, Mm, Mm, Mm, Mm, Mm, Hh, Mm, Hh, Hh, Hh^Dr, Re, Hh^Dr, Hh^Vhh, Mm, Mm, Mm, Mm, Mm, Mm, Mm, Hh, Hh^Esa, Hh, Gg, Gg, Gg^Edt, Gg
Mm, Mm, Mm, Mm, Mm, Mm, Mm, Mm, Mm, Mm, Mm, Hh, Gs, Gd, Gs, Rb, Gg, Hh, Hh, Mm, Mm, Mm, Hh^Vhh, Hh, Hh, Hh, Rp^Esa, Gg^Esa, Re, Re, Re^Edt, Rb^Edt
Hh, Mm, Hh, Hh, Hh^Vo, Mm, Hh, Hh, Hh, Mm, Gg, Gg, Hh, Hh, Gg^Es, Re, Rb, Gg, Hh, Hh, Hh, Hh, Gg, Hh, Gg^Edt, Gs, Rp^Edt, Rb, Gs^Cov, 3 Gd^Kov, Gd^Fdw, Gs
Hh, Hh, Gg, Gs, Gs, Hh, Gg, Hh, Mm, Gg, Gg, Gg, Gg, Hh, Gg, Gg, Rb, Gs, Re^Esa, Rp, Gd, Gg, Gg^Efm, Gg, Rb, Re, Gs^Edt, Gs^Edt, Gg, Gg^Cov, Gs^Edt, Gll
Gd, Gs, Hh, Gg, Gg^Es, Gg, Gg^Es, Hh, Hh, Hh, Gg, Gg, Gg^Es, Gg, Gs, Gg, Aa, Rb^Esa, Gs^Esa, Gs, Gd^Es, Re, Re, Re, Gs, Re, Rb, Gg, Aa^Qhhf, Aa^Vla, Aa^Qhh, Gg^Qhh
Hh, Hh, Hh, Mm, Mm, Gg, Gs, Gll, Ss^Qhu, Gll^Fdw, Gg^Efm, Gg, Gg, Gd^Vo, Hh^Esa, Aa, Aa^Fda, Aa, Aa, Re^Es, Gs, Gg^Efm, Gg^Efm, Gg, Aa, Aa, Rb, Aa^Qhh, Ww^Ewl, Ha^Qhh, Ww, Ww
Hh, Hh, Mm, Mm, Mm, Gs, Gd^Fdw, Ss^Qhu, Ss^Qhu, Gll, Gg, Gg, Gs, Hh, Hh, Hh, Mm, Hh, Gs, Gd, Gg^Ve, Gs^Fds, Gs, Gs, Gs, Hh, Gg, Aa^Qhh, Ww, Ww^Ewf, Ww^Ewf, Ww
Hh, Hh, Mm, Mm, Gg, Gs, Gd^Fetd, Gll^Fdw, Gd^Fdw, Ss, Gg, Gg, Gll^Fdw, Aa, Hh, Mm, Mm, Hh, Gg, Gg, Aa, Gs^Fms, Aa, Gd^Fdw, Gll, Gs^Fds, Hh^Qhh, Ha^Qhh, Ww^Ewf, Ww, Wo, Wo
Hh, Hh, Gs, Gs, Gg, Gd^Fdw, Gll^Fdw, Gll^Fdw, Gg, Gd^Fdw, Gg, Gg, Gs, Gd^Fdw, Aa, Hh, Gg, Gg, Gs^Fds, Hh^Fds, Hh^Esa, Aa^Fma, Hh, Hh, Gs^Qhh, Gg^Qhh, Ww^Ewl, Hh^Qhh, Ww, Ww, Wo, Wo
Gg, Gg, Ss, Gd^Fdw, Gg, Gg, Gg, Ss^Qhu, Gs^Vc, Gg^Efm, Gg, Gg, Gg^Efm, Gg, Gs, Gs, Hh^Esa, Aa, Aa, Hh, Hh, Hh, Hh^Vhh, Gg, Ha^Qhh, Ww^Ewf, Ww^Ewf, Ww, Ww, Ww, Wo, Wo
Gg, Gg, Gs, Gg, Gll^Edt, Gg^Edt, Re, Gs, Gll^Fdw, Gg^Edt, Gg^Edt, Gg, Gg^Efm, Gg^Efm, Aa, Gd, Hh, Hh^Esa, Hh, Aa^Fda, Ha, Hh, Hh, Gs^Qhh, Ww^Ewl, Ww, Ww, Ww, Wo, Wo, Wo, Wo
Ss, Gd^Fdw, Gd^Fdw, Gd^Vh, Rb, Re^Emf, Ce, Ce, Ce^Em, Gd^Edt, Gg^Ebn, Gg, Gs, Aa, Aa^Fma, Hh, Mm, Hh, Aa^Qhh, Aa^Fma, Gs^Qhh, Gd, Gs^Qhh, Gg^Qhh, Ww, Ww, Ww, Wo, Wo, Wo, Wo, Wo
Ss, Gll^Fdw, Gll^Fdw, Rb, Gd, Ss^Em, 1 Ke, 2 Ke, Re^Tf, Gd^Emf, Gs^Edt, Gg^_mh, Gg, Gd, Gs^Vc, Hh, Mm^Qhh, Mm^Qhh, Ww, Gg^Qhh, Ww, Ds^Qhh, Ww, Ww, Ww, Ww, Wo, Wo, Wo, Wo, Wo, Wo
Gd^Fdw, Gs, Gs^Qhh, Gs, Re^Qhh, Ce, Ce, Ce, Re^Qhh, Gll^Qhh, Gd^Qhh, Gg, Aa^Qhh, Gs^Qhh, Ds^Qhh, Hh, Hh^Qhh, Ww^Dr, Ww, Ww, Ww, Ww, Ww, Ww, Wo, Wo, Wo, Wo, Wo, Wo, Wo, Wo
Gd^Qhhf, Gll^Qhhf, Ww, Gg^Qhh, Ww, Rb^Qhh, Rb^Qhh, Re^Qhh, Ww, Ww, Ww, Hh^Qhh, Ww, Ww, Ww, Ds^Qhh, Ww, Ww, Ww, Ww, Wo, Ww, Wo, Wo, Wo, Wo, Wo, Wo, Wo, Wo, Wo, Wo
Ww, Ww, Ww, Ww, Ww, Ww, Ww, Ww, Ww, Ww, Ww, Ww, Ww, Ww, Ww, Ww, Ww, Ww, Wo, Wo, Wo, Wo, Wo, Wo, Wo, Wo, Wo, Wo, Wo, Wo, Wo, Wo
