Mm, Mm, Mm, Mm, Mm, Mm, Mm, Mm, Mm, Mm, Mm, Mm, Mm, Mm, Mm, Hhd, Hhd, Gg, Md, Md, Md, Md, Md, Hhd, Ha, Ms, Ms, Ms, Ms, Ms, Ms, Ms
Mm, Mm, Mm, Mm, Mm, Mm, Mm, Mm, Mm, Mm, Mm, Mm, Mm, Mm, Mm, Mm, Mm, Hhd^Esa, Hhd, Md, Md, Md, Hh, Hhd, Chr, Ha, Ms, Ms, Ms, Ms, Ms, Ms
Mm, Mm, Mm, Mm, Mm, Mm, Mm, Mm, Mm, Mm, Mm, Mm, Mm, Mm, Mm, Mm, Mm, Mm, Hhd^Vu, Hhd^Dr, Ms, Ha, Ha, Chr, 4 Khr, Chr^Edb, Hh, Ms, Hhd, Ms, Ms, Ms
Hh, Mm, Hh^Fdw, Mm, Mm, Mm, Mm, Mm, Mm, Mm, Hh, Mm, Mm, Mm, Mm, Mm, Gd^Fdw, Hhd, Ha, Ha^Esa, Re^Esa, Hh, Rb^Edb, Chr^Edb, Chr^Edb, Chr^Edb, Rp, Hhd^Esa, Ha, Ms, Ms, Ms
Mm, Hh, Mm, Hh^Fdw, Rp, Mm, Mm, Hh, Mm, Mm, Gs^Fp, Hh^Fdw, Gs^Esa, Hh, Hh^Vhh, Gs^Fdw, Gg, Gd^Fdw, Gs, Rp, Wwf, Rb, Hhd^Qhux, Re^Edb, Re^Em, Re^Emf, Re^Em, Hhd, Ms, Ms, Ms, Ms
Mm, Hh^Em, Cfr^Em, Cfr, Cfr, Hh^Esa, Ha, Hh^Fdw, Gs^Vh, Gg^Esa, Gs^Esa, Gg, Gg, Gd, Gd, Gs, Md, Gg^Efm, Rp, Md, Md, Hhd, Ha^Qhux, Hhd^Qhux, Hh^Fdw, Hh, Re^Esa, Hh^Vhh, Hhd, Ms, Ms, Ms
Rb, Re^Emf, Cfr, 3 Kfr, Cfr, Aa, Ha, Aa, Gs^Fdw, Md, Md, Md, Md, Hhd, Md, Md, Md, Hhd, Re^Esa, Rp^Esa, Hhd^Es, Ha^Qhux, Ha^Qhux, Hh^Qhux, Hh^Edb, Gs^Fdw, Re, Hh^Esa, Hhd, Ha, Ms, Ms
Hh, Mm, Hh^Esa, Cfr^Esa, Rb^Emf, Ha, Aa, Aa^Es, Hh, Hhd^Fdw, Hhd, Md, Md, Md, Md, Md, Gg, Gs, Ww, Gs^Esa, Gd, Ha^Qhux, Aa^Esa, Aa, Gs^Fdw, Gd^Vo, Re, Ha, Ms, Ms, Ms, Ms
Mm, Hh^Esa, Aa, Rb, Hh^Vhh, Re^Em, Hh, Rp, Ha, Ha, Hhd, Md, Hhd, Md, Wwf, Hhd, Gg, Ha, Ha, Aa^Fda, Aa^Fda, Aa, Gg, Hh, Rb, Rb, Rb^Edt, Hh, Hh^Fdw, Ms, Ms, Ms
Mm, Mm, Mm, Mm, Hh, Rp^Esa, Gg, Re^Ecf, Gs^Edt, Hhd, Aa, Gs^Fp, Gd, Aa, Gg, Aa, Ha^Qhux, Ha^Qhux, Ha^Qhux, Ha^Qhux, Aa^Fda, Aa, Gg^Es, Gd, Aa^Esa, Gd^Esa, Wwf, Rp, Rb^Edt, Ms, Ha, Ha
Mm, Mm, Hh, Mm, Gg, Aa, Ha, Gg^Edt, Gg^Es, Gg, Wwf, Gs^Edt, Wwf, Gg, Gs^Emf, Aa, Aa^Vha, Ha^Qhux, Hhd^Qhux, Ha^Qhux, Hh^Qhux, Aa, Gs^Fp, Gg, Aa, Aa^Esa, Gg, Rp^Esa, Gg, Rb^Edt, Re, Rb
Ha, Ha, Ms, Ms, Gs, Hh, Ha, Aa, Gs, Gs, Hh, Ww, Ha, Wwf, Gs^Em, Gd, Gd^Fdw, Hhd^Qhux, Hhd^Qhux, Hhd^Qhux, Aa, Ha, Gs, Gg, Gg^Es, Gg, Aa^Vca, Gs^Fdw, Gd^Fdw, Gg^Efm, Gs, Gd
Ha, Ha, Ha, Ms, Gd, Hh^Esa, Mm, Mm, Gd^Esa, Gs^Fp, Gs^Fp, Hh, Hhd, Hhd, Aa^Fda, Aa, Aa, Aa, Ha, Aa, Hhd, Gd, Hhd, Aa, Aa^Fda, Aa, Aa^Esa, Hhd^Fdw, Hhd, Ww, Wwf, Gg
Ms, Ms, Ha, Hhd, Ha, Gs, Aa, Gs, Gs^Vh, Gs^Fp, Hhd, Md, Md, Md, Md, Hh, Hh^Qhux, Hh^Qhux, Hh^Qhux, Hhd^Qhux, Hhd^Qhux, Hhd^Qhux, Hhd^Esa, Hhd^Fdw, Hhd, Hh, Ha, Hhd^Esa, Ha, Hhd^Esa, Gd, Aa
Ha, Ms, Ms, Hhd, Ha, Ms, Ms, Aa, Aa, Hh, Md, Md, Md, Md, Hh, Hh^Qhux, Hh^Qhux, Hh^Qhux, Hh^Qhux, Hh^Qhux, Md, Hhd^Qhux, Hh^Dr, Hh^Vu, Ms, Aa, Ms, Ms, Aa, Ha^Esa, Hh, Gs
Ms, Ms, Ms, Ha, Ms, Ms, Ha, Gd^Fdw, Gs^Fdw, Gg^Efm, Gs^Em, Md, Md, Md, Hhd, Aa, Hhd, Hh^Qhux, Md, Md, Md, Md, Ms, Ms, Ms, Ms, Ms, Ms, Aa, Ha, Aa, Hhd
Ms, Ms, Ms, Ms, Hhd, Hhd, Hh, Gd^Fdw, Wwf, Aa, Gg, Hhd, Md, Md, Md, Hhd, Md, Md, Md, Md, Aa, Ms, Ha, Ms, Ms, Ms, Ms, Aa, Ms, Ms, Ms, Ms
Ms, Ms, Ha, Ms, Hhd^Dr, Hhd^Vu, Hh, Hh, Aa, Aa, Gd, Aa, Hh, Md, Ha^Esa, Aa^Esa, Ha, Aa, Aa, Ha, Ms, Ha, Ms, Ms, Ms, Ms, Ms, Ha, Ms, Ms, Ha, Ms
Mm, Mm, Hh, Hh, Hh^Fdw, Ha, Ms, Ms, Ms, Gs, Aa, Md, Md, Aa, Ms, Ha, Ms, Aa, Ha, Ms, Ha, Ha, Ms, Ms, Ms, Ms, Ms, Ms, Ms, Ms, Ms, Ha
Hh, Mm, Mm, Mm, Hh, Ms, Hhd^Fdw, Hhd^Esa, Hhd^Esa, Gs^Fp, Aa, Hhd, Ha^Vhha, Hhd^Fdw, Ms, Ms, Ms, Ms, Ms, Ha, Ms, Ms, Ms, Ms, Ha, Ms, Ms, Ms, Ms, Ms, Ms, Ms
Hh, Mm, Mm, Mm, Mm, Hh^Fdw, Hh, Hhd, Wwf, Wwf, Gs^Edt, Gg^Efm, Rb, Hhd^Fdw, Hhd^Esa, Ms, Ms, Ms, Aa, Ms, Aa, Ms, Ms, Aa, Ms, Ms, Ms, Ms, Ms, Ms, Ms, Ms
Mm, Mm, Mm, Mm, Mm, Mm, Mm, Hh^Esa, Gd^Fdw, Gd, Ce^Edt, Gs^Esa, Hh, Hh, Md, Hhd, Ms, Ha, Aa, Aa, Ms, Ha, Aa, Ha, Ms, Ms, Ms, Ha, Ms, Ms, Ms, Ha
Mm, Mm, Mm, Mm, Mm, Mm, Mm, Mm, Gd^Fdw, Ce, 1 Ke, Ce^Edt, Re, Aa, Hhd^Vhh, Md, Md, Ha, Aa, Ms, Ms, Ms, Ha, Ms, Ms, Ms, Ms, Ms, Ms, Ms, Ha, Ha
Mm, Mm, Mm, Mm, Mm, Hh, Mm, Hh^Fdw, Mm, Hhd, Ce, 2 Ke, Ce, Hh^Fdw, Md, Md, Md, Aa, Aa, Ms, Ms, Ms, Ms, Ha, Ms, Ms, Ms, Ms, Ms, Ms, Ms, Ms
Mm, Mm, Mm, Mm, Mm, Mm, Mm, Hh, Mm, Hh^Esa, Rb, Ce^Em, Re^Emf, Re, Md, Md, Ha, Aa, Ha, Ha, Ms, Ms, Ms, Ms, Ha, Ms, Ms, Ms, Ms, Ms, Ms, Ms
Mm, Mm, Mm, Mm, Hh, Mm, Mm, Hh, Hh, Hh, Hh, Hhd^Fdw, Md, Md, Md, Md, Aa, Aa, Ms, Ms, Ms, Ms, Ms, Ms, Ha, Ha, Ms, Ms, Ms, Ms, Ms, Ms
