Uh, Uh, Ur^Em, Ur, Hhd^Edt, Qxu, Qxua, Xu, Xu, Mm, Mm, Mm, Mm, Hh, Ww, Hh^Qhh, Hh, Hh, Mm, Mm, Mm, Hh, Mm, Hh, Hh, Hh^Fp, Gs^Fp, Hh^Fp, Hh, Mm, Mm, Mm, Mm, Mm, Hh, Hh
Uu, Uh, Uu^Vud, Ur^Edt, Ur^Edt, Uh, Uh, Xu, Mm^Xm, Mm, Mm, Mm, Mm, Hh, Wwr, Hh^Qhh, Mm, Hh^Fdw, Hh^Em, Mm, Gs^Fp, Mm, Hh, Mm, Gg, Gs^Fp, Gs^Fp, Gs^Fp, Hh, Hh, Mm, Mm, Mm, Mm, Hh, Hh
Hhd, Uu^Emf, Uu^Em, Cud, 6 Kud, Cud, Uh, Uh^Ii, Mm^Ii, Mm, Mm^Xm, Mm, Hh, Wwf, Hh, Hh^Qhh, Re^Edb, Gg, Gs^Emf, Gd^Edb, Gs^Edb, Cer, Cer, Hh, Gg, Hh, Gs^Fp, Ww, Ww, Wwr, Gs, Mm, Ww^Ewl, Hh, Mm, Mm
Qxu, Hhd^Em, Xu, Cud, Cud, Cud, Uu^Edb, Hh^Edb, Hh, Mm^Xm, Ha, Mm^Xm, Hh, Ww, Ww^Ewl, Re^Qhh, Mm, Rb^Em, Rb^Em, Cer^Edb, Cer^Edb, 4 Ker, Cer^Em, Hh^Fdw, Gg^Ve, Hh^Fp, Gs^Fp, Gg, Gs^Fp, Gg, Ww, Ww, Gs^Fp, Ww, Ww, Ww
Xu, Hhd, Uh^Ii, Uu^Ii, Uh, Uu, Hhd, Hh^Edb, Qxu, Hh, Wo, Ww, Ww, Ww^Ewf, Gg^Qhh, Hh^Qhh, Mm, Mm, Gg, Re, Hh, Cer, Aa, Gg, Aa, Aa^Fpa, Gs^Fp, Hh^Fp, Gg^Esa, Gg, Ha, Gs^Fp, Gs^Fp, Ww^Ewf, Gd, Gs^Fp
Mm, Xu, Xu, Uu^Ii, Qxu, Hhd, Ww, Hhd^Vhhr, Ww, Wo, Gs^Qhh, Gs^Qhh, Gd^Qhhf, Gg^Qhh, Hhd^Fdw, Ha, Cer, Mm, Cer^Edb, Re^Edb, Rb, Gg, Re, Gs, Gs^Edb, Aa, Aa, Aa^Esa, Aa, Gg, Hh^Fp, Gs^Fp, Gg, Gs, Gg, Gs^Fp
Mm, Mm, Mm^Xm, Qxua, Qxua, Wwr, Wwr, Wwf^Edb, Gs^Qhh, Gg^Qhh, Gs, Gd^Fdw, Aa, Gs^Fdw, Gd^Fdw, Ha, Cer, 3 Ker, Cer, Gg^Edb, Gg, Re^Esa, Gg, Re, Gd, Gs^Vc, Aa^Fpa, Aa^Fpa, Gg, Gg, Hh^Vhh, Gs, Gs^Fp, Hh, Hh, Gg
Mm, Mm, Mm, Mm^Xm, Hh, Wwf^Edb, Wwf, Gs^Qhh, Gs^Esa, Gd^Fdw, Gg, Aa^Fda, Aa, Gg, Ha, Hhd, Gg^Edb, Cer^Edb, Gs, Re, Gg, Gg, Gs^Fp, Gg, Gg, Re, Gs, Gg, Aa, Gg, Gs, Gg, Hh^Fp, Hh, Mm, Hh
Hh, Hh, Hhd^Vhhr, Mm, Ww^Ewl, Wwf, Ww, Gg^Qhh, Gg^Es, Gs, Re, Aa, Gs^Edb, Gs^Fdw, Gs^Fdw, Gd^Fdw, Aa, Aa, Gs, Re^Edb, Gs^Edb, Hh, Ha, Aa^Fpa, Gg, Re, Re, Re, Rb^Esa, Gd, Re, Hh, Mm, Mm, Mm, Mm
Ww, Wwr, Wwr, Ww, Gg^Qhh, Ww, Gg^Qhh, Gg^Qhh, Gg, Rb, Re, Gd^Edb, Gd^Emf, Gd^Vhr, Aa^Fda, Gg, Gs^Esa, Gd^Fdw, Gg^_mh, Rb^Edb, Hh, Aa, Gs^Fp, Gs^Fp, Gg, Gg, Rb^Gvs, Rb^Gvs, Hh, Rb, Rb^Gvs, Mm, Mm, Mm, Mm, Hh
Aa^Qhh, Gs^Qhh, Gs^Qhh, Gd^Qhhf, Aa, Gs^Qhh, Gg^Efm, Gg^Efm, Gg, Gs, Rb, Gd, Gs, Ha, Aa, Aa^Esa, Aa, Gg, Re^Edb, Rb, Gg, Gs, Gg, Gg, Re, Rb^Gvs, Re^Gvs, Re^Gvs, Rr, Re^Gvs, Hh, Mm, Hh, Mm, Mm, Mm
Aa, Aa, Gg^Edt, Gd^Fdw, Gs, Gs, Gg, Gg^Es, Gs, Gd^Fdw, Gd^Fdw, Re, Gg, Aa, Gg, Gd, Gs^Vh, Rb, Gg, Gg^Es, Aa, Gg, Gg, Gs^Vo, Rb, Re^Gvs, Re^Gvs, Rb^Gvs, Gs^Fp, Hh, Hh^Fdw, Hh, Mm, Mm, Mm, Mm
Ha, Gs^Fdw, Gg, Gg^Edt, Gg, Gg, Gs^Fp, Gs^Vl, Hh, Hh, Ww, Ww, Ww, Gg, Gg^Es, Gg^Es, Rb, Rb, Gg, Aa, Aa, Gg, Re, Re, Rb^Gvs, Rp, Rr, Hh, Gs^Esa, Hh, Gs^Fp, Hh^Fdw, Gs^Fp, Rp, Gs^Fp, Hh
Mm, Mm, Mm, Gs, Gg, Gg, Gs, Gs^Fp, Aa, Hh^Esa, Hh, Gg, Ww^Bw/, Gg, Wwf, Gs, Rp, Hh, Gs, Gg, Gg, Gs, Re, Rb^Gvs, Re^Gvs, Rb^Gvs, Hh, Gg^Esa, Gg, Hh, Rr, Gs^Fp, Co, Rr, Gs^Fp, Gs^Fp
Mm, Mm, Mm, Mm, Hh, Gg, Gg, Gg^Efm, Gg^Esa, Gs^Esa, Gg, Gg, Gg, Wwr, Ww, Hh, Hh, Rp, Ww, Gg, Hh, Re, Re^Gvs, Re^Gvs, Rb^Gvs, Re^Gvs, Hh, Hh, Gg, Gs^Ebn, Gs^Esa, Co^Esa, 5 Ko, Co, Rb^Gvs, Rb^Gvs
Mm, Mm, Mm, Mm, Mm, Gg, Gg, Gg, Gg, Gg, Hh, Gg, Gg, Gg, Gs, Hh, Aa, Re, Ww, Gg, Gg, Gg, Gs, Rb^Gvs, Gs, Gg^Efm, Gg^Efm, Gs, Hh, Re, Co, Rr, Re^Gvs, Co, Re^Gvs, Hh
Mm, Mm, Mm, Mm, Gs^Fms, Gs, Gg^Es, Gg, Gg, Hh, Hh^Esa, Hh^Fdw, Re, Re, Rb, Hh^Vhh, Rb, Rb, Ww, Wwf, Wwf, Gg^Efm, Re^Gvs, Gd, Gs, Gg, Rb^Gvs, Rb^Gvs, Re^Gvs, Re, Co^Esa, Ko, Re^Gvs, Re^Gvs, Re^Gvs, Hh
Mm, Mm, Aa, Aa, Gs^Fms, Gd, Gs^Vh, Gg, Gg, Gs, Re^Esa, Re, Hh, Gs, Gd, Rp, Gs, Ww, Hh, Wwf, Ww^Ewf, Hh, Re^Gvs, Re^Gvs, Gs, Re^Gvs, Re^Gvs, Re^Gvs, Re^Gvs, Rr, Rp, Hh^Esa, Hh, Re^Gvs, Rb^Gvs, Rb^Gvs
Hh, Hh, Gs, Gd^Fdw, Gg, Re, Hh, Gg, Gg, Gs, Gg, Gs^Fdw, Gg^Efm, Gg, Gg, Gs, Hh, Ww, Mm, Hh, Gg, Ww^Ewl, Gg, Gg, Gg, Gs^Vo, Re^Gvs, Re^Gvs, Rb^Gvs, Rb^Gvs, Re^Gvs, Rb^Gvs, Hh, Rb^Gvs, Mm, Hh
Aa^Fpa, Aa^Fpa, Ce^Es, Ce, Ce^Edt, Re^Edt, Re, Gs^Ebn, Gg^Es, Gg, Gg, Gg^Efm, Gg^Efm, Gg, Gg, Gs^Fdw, Hh^Fds, Hh, Gg, Hh, Gg, Ww, Ww^Ewl, Ww, Gg, Gd^Esa, Gd, Rb^Gvs, Gs, Hh, Gs, Gd^Vo, Gs, Gg, Mm, Mm
Gd^Fdw, Gd^Fdw, Gg, 2 Ke, 1 Ke, Hh, Gg, Gg^Es, Gs^Fdw, Gg, Gs^Vc, Gg, Gs, Gg, Gg, Gg, Gg, Gg, Ww, Gg, Wwr, Ww, Hh, Hh, Ww, Gg, Hh, Gs, Gg, Gg^Efm, Re^Gvs, Re^Gvs, Hh, Hh, Hh, Hh
Gs^Fms, Gg, Re, Ce, Ce, Ce^Em, Gs^Emf, Gs^Fdw, Gs^Fds, Hh^Fdw, Hh, Gs^Emf, Gd, Gs^Fms, Gs^Fdw, Gg, Gg, Gg, Ww^Ewl, Wwr, Wwr, Hh^Vhh, Mm, Mm, Mm, Hh, Hh^Fdw, Ww, Ww, Gg, Ww, Rb^Gvs, Mm, Mm, Mm, Hh
Mm, Hh, Aa, Re, Re, Gd^Edt, Gs^Edt, Gs^Fms, Hh, Hh, Hh^Fds, Gd, Gg, Gs^Fdw, Gs, Gs, Gg, Ww, Wwf, Hh, Hh, Hh, Mm, Mm, Mm, Mm, Mm, Hh, Wwf, Hh, Hh, Hh, Mm, Mm, Mm, Mm
Mm, Hh, Mm, Mm, Hh, Re^Edt, Gs^Fdw, Gg, Mm, Mm, Hh, Gs, Ww, Ww, Ww, Ww, Ww, Ww, Hh, Hh, Mm, Mm, Mm, Mm, Mm, Mm, Mm, Mm, Mm, Hh, Mm, Mm, Mm, Mm, Mm, Mm
