Gd^Esa, Gd, Rp, Aa, Hh, Hh, Hh, Mm, Hh, Mm, Mm, Mm, Mm, Mm, Mm, Hh, Hh, Hh, Gs^Fp, Hhd, Hhd, Gll^Fdw, Gll^Fdw, Gll^Fdw, Gg, Gg, Gs, Gg, Gg, Hh, Gs^Fp, Gs^Fp, Hh, Hh, Mm, Gg, Mm, Gg
Aa, Aa, Rp^Em, Re, Re, Hh, Aa, Mm, Mm, Mm, Mm, Mm, Mm, Mm, Mm, Hh, Gs^Fp, Gs^Fp, Gg, Gg, Gll, Gll, Rp, Rp, Rp^Edb, Gs^Edb, Gd^Vhr, Hh, Gs^Fdw, Gg, Gs, Gg, Gs^Fdw, Hh, Mm, Mm, Mm, Mm
Aa, Gs^Esa, Ce^Em, Ce, 2 Ke, Ce, Aa, Mm, Hh, Hh, Mm, Mm, Mm, Mm, Gg, Gs, Gg, Gs, Hh, Gll^Fdw, Hhd^Fdw, Hhd^Fdw, Hhd, Gd, Cer, Rb, Re, Rp, Hh^Fdw, Gs, Gd, Ss, Ss, Gll, Gg, Gg, Mm, Mm
Aa, Gg, Ce^Esa, 1 Ke, Ce, Ce, Aa, Aa, Aa^Esa, Hh, Gs^Fp, Hh, Gs, Gg^Efm, Mm, Mm, Mm, Gg^Ve, Gs^Fdw, Gd^Fdw, Gll^Fdw, Gll^Fdw, Rb, Cer, 5 Ker, Cer, Rb^Edb, Gll^Fdw, Gd^Fdw, Hhd, Gll, Ss, Gll, Gs^Fms, Hh^Fds, Hh^Fds, Hh^Fds, Mm
Gs, Gg, Aa, Rp, Gs^Em, Re^Em, Re, Gd^Esa, Gs, Gs, Gg^Ve, Gg, Gll^Fdw, Hhd, Mm, Mm, Mm, Gll, Gd, Ss, Gd^Fdw, Rb^Dr, Re, Cer, Cer, Cer^Edb, Gd^Edb, Rb^Edb, Rp, Re, Gg, Gll^Fdw, Ss, Hh, Gs^Qhhf, Hh^Qhh, Mm^Qhh, Mm
Gg, Gg, Gg, Gs, Gs^Vc, Gs^Emf, Gg, Rp, Gg, Gg^Efm, Gg^Efm, Gs^Fdw, Gd^Fdw, Hh, Gd^Fdw, Mm, Hh, Gs, Gs, Rp, Hh, Gll^Fdw, Hhd, Gll^Fdw, Gll^Edb, Gd^Edb, Gs^Fdw, Gd, Gg^Edb, Gg^Edb, Gg, Hh^Fds, Gs^Qhhf, Gs^Qhhf, Hh, Hh, Mm, Hh
Gs^Fds, Gs^Fds, Mm, Gs^Fp, Hh, Gg, Gs^Fds, Re, Re, Gg, Rp, Gll, Gll, Ss, Ss, Gll^Fdw, Gs^Edt, Gg^Edt, Gg, Gd^Fdw, Hhd^Edb, Hhd^Vhhr, Gd, Gd^Edb, Gg, Gg^Edb, Gg, Gg^Dr, Gs^Fdw, Hh^Edb, Hh^Fp, Hh^Qhh, Gs^Fms, Gs^Fp, Hh^Fds, Hh^Fds, Gs, Gs^Fds
Gg, Mm, Mm, Mm, Mm, Gs^Fds, Gs^Fds, Gd, Gs, Rp, Gg, Re, Gll, Ss, Gll, Ss, Gs^Fp, Gg, Gg^Es, Gs^Edt, Gg^Edt, Gs, Gs^Fp, Gs^Fp, Gs^Fp, Gg, Gs^Fds, Gg, Hh, Ww, Wwf, Hh^Qhh, Gg, Gs^Fds, Gs^Fp, Gs^Fds, Gg, Gg^Es
Hh, Hh, Mm, Mm, Hh, Hh, Gg^Esa, Gs^Esa, Re, Gg, Gg, Re, Re, Re, Re, Gs^Fp, Re, Gg, Gs, Gg, Gs^Fp, Rp, Wwr, Hh^Fp, Gs^Fds, Gg, Gs^Fp, Gs, Wwr, Ww^Ewl, Gg^Qhh, Hh^Qhh, Ww, Gg, Gg, Gg, Hh, Hh^Fds
Gg, Hh, Gs^Fds, Gs^Fds, Gs^Fp, Gs, Gg, Rp, Re, Gs, Gd^Esa, Gs^Fp, Gs, Gg^Fet, Gg, Rr, Gs^Vl, Re, Rr, Gd^Es, Hh, Hh, Ww^Ewf, Gs^Fds, Gs^Fds, Gg, Hh^Qhhf, Gs^Fds, Ww, Gg^Qhh, Gs^Fp, Gg, Gg, Gs^Es, Gg^Es, Gg, Gs, Hh^Fds
Gs, Gg, Gs, Gs^Fds, Gg^Efm, Gg^Efm, Gg^Efm, Gg, Re, Gs, Gg, Gs, Gg^Es, Gg, Gs^Fp, Gg, Gs^Fp, Mm, Mm, Rr, Ww^Bw\, Ww, Gs^Qhhf, Wwf, Wwf, Hh^Qhh, Gs^Fms, Hh^Qhhf, Gs^Qhh, Gg^Qhh, Gs^Fp, Gs^Fp, Hh^Fds, Hh, Gg, Hh, Gs^Fds, Gg
Gd, Gg^Esa, Gg, Gg, Hh, Gll^Fdw, Gd^Fdw, Gd^Fdw, Gs, Re, Gs, Gg, Gg, Gs^Fp, Gs^Fds, Gg, Mm, Mm, Mm, Rr, Ww, Rr^Qhh, Gs^Fms, Re^Qhh, Rb^Qhh, Gs^Qhh, Re, Gg, Gg, Gs, Gs^Fds, Gs^Fp, Gs^Fds, Hh^Fds, Gg, Gs^Fp, Hh^Fds, Gs^Fds
Hh, Gs^Fds, Gg, Gg, Gs^Fp, Hhd^Fdw, Gg, Gs^Fdw, Gg, Gs^Vhr, Gs^Fp, Gg, Gs^Fp, Gg, Gg, Gg, Mm, Mm, Hh^Fp, Hh, Wwf, Gg^Qhh, Gg, Gs^Fp, Re, Rr, Hh^_mh, Re, Gs^Fds, Gd, Rb, Gg^Ve, Gs^Fds, Gs^Fds, Gs^Fms, Gg^Efm, Gs, Hh^Fds
Hh^Fds, Hh, Gg, Gg, Gs, Gs, Gs, Gg, Gg, Gs^Es, Gd, Gs^Fds, Gs^Fds, Gs^Fp, Hh, Gs^Fp, Gs^Fp, Gs^Fp, Wwr, Hh, Wwf, Gg^Qhh, Gs^Fp, Hh^Fp, Hh^Fp, Hh^Fds, Hh, Re, Gs^Fds, Gs^Fds, Rb, Gs^Fp, Hh^Fds, Gs^Fds, Cv, Hh, Gd, Gs
Gg, Gg, Gg, Gs^Fp, Gll^Fdw, Gd, Gd, Gs, Gg, Gg^Efm, Gs^Fp, Gs^Fp, Gd, Gs, Gs^Fp, Gs^Fp, Re, Hh, Ww, Ww, Gd^Qhh, Gs^Qhh, Gs^Fp, Hh, Gs^Fp, Gg, Gg, Rb, Gs, Re, Gs^Fms, Rr, Hh, Cv, 4 Kv, Cv, Hh, Rp
Gs^Fp, Gg, Gs, Hhd, Hhd^Fdw, Hhd^Vhhr, Gd^Fdw, Hh, Gd^Fdw, Gg, Gs, Gg, Hh^Fms, Re, Re, Rr, Rb, Gd, Gg^Qhh, Hh^Qhh, Rb, Gs^Fp, Gs^Fds, Gs^Fds, Hh, Gg, Gs^Fds, Gg^Efm, Gg^Efm, Gs^Fds, Hh^Fds, Rr, Rb^Em, Cv, Cv, Cv, Hh, Hh
Gs^Fp, Gs^Fp, Gs^Vo, Gd^Fdw, Gd^Fdw, Re, Rb, Gd^Fdw, Hh^Fdw, Gd, Gd^Esa, Gs, Gs^Fp, Gs^Fms, Gg, Gs^Fp, Gs^Qhhf, Hh^Qhh, Hh, Rb, Mm, Re, Gs, Gs^Fds, Hh^Vhh, Mm, Hh, Gs^Fms, Rr, Gs^Fds, Mm, Gs^Fds, Gs^Emf, Re, Rr, Hh, Hh^Fds, Hh^Fds
Hhd, Hhd, Hh, Hhd, Rb, Rb^Edb, Cer^Edb, Rp, Rp^Dr, Rp, Rb, Rb, Rb, Gd, Gs^Fp, Hh^Fp, Hh^Qhhf, Hh^Fds, Mm, Mm, Mm, Re, Gs^Fds, Hh, Mm, Mm, Mm, Hh, Gs^Fp, Gd, Mm, Mm, Gg, Gg^Fet, Gs^Fds, Gg^Ve, Hh^Fp, Gs^Fds
Hh^Fdw, Mm, Rp^Edt, Rp, Gd, Cer^Edb, 3 Ker, Cer, Gll^Fdw, Rb, Gll^Fdw, Gd^Fdw, Rp, Gs, Hh, Hh^Qhh, Hh, Hh, Mm, Mm, Mm, Mm, Gs^Fds, Hh^Fds, Mm, Mm, Mm, Mm, Mm, Re, Rb, Hh, Gg, Gs^Fds, Rb, Re, Gs^Fp, Gs^Fp
Gs, Hh, Re, Gll^Fdw, Gd^Fdw, Cer, Cer^Edb, Cer, Gll^Fdw, Hh, Re, Gd^Fdw, Gg, Gg, Hh^Qhh, Hh^Qhhf, Mm, Mm, Mm, Mm, Mm, Hh, Gs^Fms, Mm, Mm, Mm, Mm, Mm, Mm, Hh, Gs^Fds, Rb, Gg^Efm, Gd, Gs, Gs^Fp, Hh, Hh^Fp
Re, Gd, Mm, Hhd^Fdw, Hhd^Fdw, Rb, Rb^Edb, Rb^Edb, Gs, Gd^Edb, Gg, Gg, Hh, Gs^Qhh, Hh, Hh, Gs^Fms, Mm, Hh, Mm, Gs^Fds, Gs, Gg, Gg, Gs^Fp, Hh^Fds, Gs^Fds, Mm, Gs^Fp, Hh, Gs^Fp, Re, Gs, Gs^Fms, Gs^Fds, Gg, Hh^Fds, Hh
Gg, Hh, Mm, Mm, Gd^Fdw, Gll^Fdw, Gll^Fdw, Gg, Hh, Hhd, Gs^Fp, Gs^Fp, Mm, Mm, Mm, Hh^Fds, Gs^Fds, Gg, Gg, Hh^Fms, Gs^Fms, Gg, Gs^Fp, Gg^Fet, Gg, Gs^Fds, Gs^Fds, Gs^Fp, Gs^Fp, Gs^Fp, Gg, Re, Gs^Fms, Gs^Fp, Mm, Mm, Mm, Mm
