Mm, Mm, Hh, Mm, Mm, Mm, Mm, Mm, Mm, Mm, Hh, Gs^Fds, Gs^Fp, Hh, Mm, Mm, Mm, Mm, Mm, Mm
Mm, Hh^Fp, Gg, Mm, Mm, Mm, Mm, Mm, Mm, Hh^Fds, Gg^Fet, Gs^Fds, Gs, Gs^Fds, Hh, Hh, Mm, Mm, Mm, Mm
Gs^Fp, Gs^Fp, Hh, Mm, Mm, Mm, Mm, Mm, Mm, Mm, Hh, Gs, Gg, Gs^Fp, Gs^Fp, Hh^Fds, Gs, Gg, Mm, Hh
Gg, Gg, Gs^Fms, Mm, Mm, Mm, Mm, Mm, Gs^Fms, Hh, Gg^Efm, Gg, Gg, Hh, Gg, Gs^Fds, Gg, Mm, Mm, Mm
Mm, Mm, Hh, Gs, Gg, Hh^Fds, Hh^Fp, Hh, Gs^Fds, Gs^Fms, Gg^Efm, Gg^Efm, Gs^Fp, Gg, Gg, Gg, Gs^Fds, Gs^Fds, Hh, Mm
Mm, Mm, Mm, Gs^Fp, Gs^Fds, Gg, Gg, Gs^Fds, Gg^Fet, Gg, Wo, Ww, Gs^Fp, Gs^Fp, Gg^Efm, Gs, Gs^Fp, Gs^Fds, Gs^Fds, Hh^Fds
Hh^Fds, Mm, Hh, Gs^Fp, Gs^Fp, Gs^Fp, Gg^Ii, Gg, Gs, Ww, Gs^Fms, Cv, Cv, Gs^Fp, Gg^Ve, Gg, Gg, Gg, Gs^Fp, Gs^Fp
Hh, Hh^Fds, Gg, Gs^Fp, Gg, Gs^Fp, Gg^Ii, Gg^Ii, Gs^Fp, Wwt, Cv, Cv, Cv, Gg^Ii, Gs^Fp, Gg^Ii, Gg, Gg, Gg, Gg
Gs^Fds, Gs^Fms, Gg, Gs^Fp, Gg^Ve, Gg^Ii, Ww, Gs^Fds, Rr, Wwf, Cv, 3 Kv, Cv, Cv, Gs^Fds, Gg^Ii, Gs, Ww, Gg, Gs^Fp
Gs^Fms, Gs^Fds, Gs, Gg^Es, Rrc, Gs^Fms, Cv, Wwt, Wo, Rrc, Wwf, Cv, Gg^Fet, Gs^Fds, Gg^Fet, Gs^Fds, Gd, Gs, Gg^Efm, Gg
Gg, Gg^Es, Ww, Gg, Gs^Fds, Gs^Fms, Gs^Fms, Cv, Cv, Rrc, Wwt, Rrc, Gs^Fms, Gs^Fds, Gg, Gs, Gs^Fms, Gs^Fms, Gs^Fp, Gs^Fp
Gs^Fms, Gs^Fp, Hh, Gg, Gs^Fds, Gs^Fds, Cv, 1 Kv, 2 Kv, Cv, Gs^Fds, Gs^Fds, Gg^Ii, Gg, Gg^Ve, Gs^Fds, Gs^Fds, Gs^Fms, Gs^Fds, Gs^Fds
Gs^Fms, Gs^Fms, Gs^Fms, Gg, Gg^Efm, Ww, Gg^Fet, Cv, Cv, Wo, Rrc, Gs^Fp, Gg^Efm, Gg^Efm, Gs^Fds, Gs^Fds, Gs^Fp, Gs^Fds, Gs^Fds, Gs^Fds
Gs^Fds, Gs^Fds, Hh^Fds, Gs^Fms, Gg^Efm, Gg^Efm, Gs^Fds, Gs^Fds, Ww, Ww, Rrc, Gg^Ii, Gs, Gs^Fp, Gs^Fds, Gs^Fp, Gs^Fds, Gg^Fet, Gs^Fp, Gs^Fms
Gs^Fms, Gs^Fds, Hh^Fds, Hh^Fms, Gg, Gg, Gg, Gs^Fp, Gg^Efm, Rr, Gs^Fp, Gg, Gg^Es, Gs^Fds, Gs, Gs^Fp, Gg, Gg, Gs, Gg
Gg, Gg, Mm, Hh, Hh, Gs^Fp, Gs, Gg, Gg, Gg, Gg, Hh, Gg, Gs, Gs^Fp, Gg, Hh^Fds, Hh, Gg, Gs^Fp
Gs^Fp, Gs, Gs, Hh, Mm, Mm, Gd, Gs^Es, Gs^Fms, Gs^Fp, Gs^Fp, Gg, Gg, Gs^Fms, Gs^Fp, Gs^Fp, Hh, Hh^Fms, Mm, Hh
Gs^Fp, Gs^Fp, Gg, Gs^Fds, Gg, Gs^Fp, Gs, Gg, Gs^Fds, Gs^Fp, Gs^Fms, Gs^Fds, Gg, Gg, Mm, Hh^Fms, Mm, Mm, Mm, Hh
Gg, Gg, Gs^Fp, Gg, Gs^Fp, Gg, Gg, Gs^Fds, Mm, Mm, Mm, Gg, Gs^Fds, Hh, Mm, Mm, Mm, Mm, Mm, Mm
Gs^Fp, Gs, Gs^Fds, Gs^Fp, Gs^Fp, Hh, Hh, Hh, Mm, Mm, Mm, Mm, Hh, Mm, Mm, Mm, Mm, Mm, Mm, Mm
