Ww^Qhux, Ww^Qhux, Ww^Qhux, Ww^Qhux, Ww^Qhux, Ww^Qhux, Hh, Hh, Mm, Mm, Hh, Hh, Mm, Mm, Mm, Mm, Mm, Mm, Mm, Gg, Hh, Hh^Fp, Hh^Fp, Gg, Mm, Mm, Hh, Hh, Mm, Mm, Mm, Mm
Ww^Qhux, Ww^Qhux, Ww^Qhux, Ww^Qhux, Ww^Qhux, Hh, Mm, Mm, Aa, Mm, Aa, Hh^Esa, Aa^Esa, Mm, Hh, Mm, Mm, Mm, Gs^Fms, Hh, Hh^Fp, Hh, Cvr, Gs^Fmw, Gs, Gs, Gg, Gs^Fp, Hh, Mm, Mm, Mm
Ww^Qhux, Ww^Qhux, Ha, Ha, Ha, Hh, Aa, Hh, Aa, Gd, Aa^Fda, Aa, Aa^Esa, Aa, Hh^Vhh, Hh, Gs, Gd^Esa, Gd^Fdw, Gs^Fds, Gs^Fms, Cvr, 3 Kvr, Cvr, Hh^Fds, Gd^Fmw, Hh, Gg^Efm, Gs^Fmw, Mm, Mm, Mm
Ww^Qhux, Ww^Qhux, Aa, Ha^Esa, Aa^Esa, Gg, Ha, Aa^Esa, Gs, Gs, Gs^Fdw, Gs^Fp, Gd^Fdw, Gs^Fmw, Gs^Fms, Gs^Fds, Gs^Fp, Gs, Gg, Gg^Fet, Gs, Cvr, Cvr, Cvr, Hh, Gs^Fms, Gg^Ve, Gg^Efm, Gd^Fdw, Gs^Fdw, Mm, Mm
Hh, Aa, Gd^Vo, Aa, Gg, Gg, Gg^Edb, Gg, Hh, Hh, Hh, Hh, Gg, Gs^Fdw, Hh, Gg^Fet, Gg, Gg, Hh^Fp, Gg, Hh, Gs^Fp, Gs^Fds, Gs^Fds, Gg^Efm, Gs^Fp, Gg, Gg, Gs, Gd, Hh, Mm
Hh, Gs^Dr, Gs, Gg, Gd, Hhd, Gll^Edb, Gs^Edb, Gg, Hh, Hh, Gs^Fp, Gs, Gs, Gs, Gg^Efm, Gg, Hh, Hh, Hh^Fms, Gs^Fds, Gs^Fmw, Hh^Fmw, Gs^Fms, Gg^Efm, Gg^Efm, Hh, Hh, Gg^Esa, Gs^Fp, Gs^Fds, Hh
Ww^Qhux, Hh, Rb, Re^Edb, Cer^Edb, Rb, Re, Gd^Fdw, Gg, Gg, Gs^Edb, Gg, Gd^Fp, Gd, Aa, Gs^Fmw, Hh, Gs, Gd, Gg^Ve, Gg, Gg^Efm, Gs^Fdw, Hh, Gg, Gs^Fp, Gs^Fds, Hh^Fp, Gg, Hh, Hh^Fms, Gs^Fms
Ww^Qhux, Ww^Qhux, Rb, Cer^Edb, 4 Ker, Cer, Rb^Edb, Re, Gg^Edb, Gg, Gs, Hh, Gs^Fp, Gs^Fp, Aa, Ha, Aa^Esa, Hh, Gs, Gs, Hh, Gg, Gg, Gg, Gg, Hh, Hh, Hh, Gg, Gg^Ve, Hh, Hh
Ww^Qhux, Ww^Qhux, Hhd^Fdw, Cer, Cer, Cer, Gd, Gll^Edb, Hhd^Dr, Gg, Gg, Gs, Gg, Gs, Gg, Aa, Gs, Gd, Gs^Fdw, Mm, Mm, Mm, Mm, Mm, Hh, Gs, Gg, Gg, Hh, Gg^Efm, Gg^Efm, Gs^Fdw
Ww^Qhux, Ww^Qhux, Ww^Qhux, Hhd, Gd^Fdw, Rb, Hh^Edb, Gs, Hhd^Vhhr, Hhd, Gd, Gs, Aa, Aa^Fda, Hh, Gg, Hh, Hh^Fmw, Hh, Hh, Mm, Mm, Mm, Mm, Mm, Mm, Hh, Gg, Hh, Hh^Fmw, Mm, Gg
Ww^Qhux, Ww^Qhux, Ww^Qhux, Gd, Hhd, Hhd^Fdw, Hhd^Edb, Md, Ha, Hhd, Gd^Edb, Aa, Ha, Hh, Aa, Gg, Aa^Esa, Mm, Mm, Mm, Mm, Mm, Mm, Mm, Mm, Mm, Gg^Efm, Gg, Gd, Mm, Hh, Hh
Ww^Qhux, Ww^Qhux, Hh, Aa, Md, Md, Ha, Aa, Ha, Re, Hhd, Gd^Vo, Hhd, Hhd, Hhd, Gg, Gg^Esa, Ha, Gd, Mm, Hh, Mm, Hh, Mm, Mm, Hh, Gg, Gs, Mm, Mm, Mm, Hh
Ww^Qhux, Ww^Qhux, Ww^Qhux, Gd^Fdw, Gs, Md, Aa, Aa^Esa, Rb, Rp, Rp, Hhd, Gs, Md, Gg, Gg, Gg, Gs, Hh, Gs, Hh, Hh, Hh, Hh, Gg, Gg, Gg^Es, Gs, Gd, Hh, Hh^Fds, Hh
Ww^Qhux, Ww^Qhux, Ha, Gs, Gg, Gs^Vhr, Gg, Re, Gg, Gg, Gg, Gg, Gg, Gg, Gg, Gg, Gg^Efm, Gg, Gg, Gs, Gd, Hh^Fds, Gs, Gs^Fds, Gs^Fds, Gs, Gg, Gg, Gg, Gs^Fds, Gs^Fms, Gs^Fp
Ww^Qhux, Ww^Qhux, Aa^Esa, Ha^Esa, Re, Gg, Rb, Re, Gg, Gs, Gs, Gg^Efm, Gg, Gg, Gd, Gs, Gg^Efm, Gg^Efm, Gg, Gs, Gg, Gs, Gg, Gs^Fds, Gg^Ve, Gg, Gg, Gg, Gs, Gg^Efm, Hh, Hh
Hh, Hh, Aa, Aa, Rb, Re^Esa, Gg, Gg, Gll^Fdw, Gll, Ss, Gg, Gg, Hh, Hh, Rp, Re, Rp, Rb, Gg, Gg, Gg, Gg, Gg, Gg, Gg, Re, Re^Edt, Ce^Edt, Gs^Edt, Gs^Fp, Mm
Hh, Hh, Rp, Re, Ss^Qhu, Gs, Gg, Gd^Em, Ss^Qhu, Ss, Gll^Fdw, Gll^Fdw, Gg, Gs^Vl, Hh, Gs, Gg^Em, Gg, Gg, Rb, Gg, Gg, Gg^Es, Gg, Gg, Gs^Ebn, Re, Ce, 2 Ke, Ce, Rb, Hh
Hh, Rb, Gll^Fdw, Gll^Fdw, Ss, Ss^Qhu, Gll^Fdw, Gd^Emf, Gs, Ss^Qhu, Gll, Gll^Fdw, Gg, Gd^Em, Ss^Qhu, Ss, Gll^Fdw, Gd^Em, Gg, Re, Gg, Gg, Gg, Gg, Hh, Gs, Ce, 1 Ke, Ce, Hh, Gs^Fms, Re
Gll, Gll, Gd, Gd^Fetd, Ss, Ss, Ss, Hh, Gll, Gg, Gg, Gg, Ss^Qhu, Gll^Tf, Ss, Ss, Ss, Gll^Fdw, Gll, Re, Hhd^Esa, Gg, Gs, Gs^Vh, Rp, Rp^Esa, Rb, Ce, Gg, Gs, Hh, Gs^Fp
Hh, Hh, Hh, Ss, Ss, Ss, Ss, Ss, Gll^Fdw, Gd, Hh, Hh, Ss^Qhu, Ss, Ss, Ss, Ss, Ss^Qhu, Gll, Rb, Hhd, Hh, Hh^Fms, Gs^Fds, Gs^Fds, Re, Hh, Rb, Mm, Mm, Mm, Hh
